ID,日期,縣市別,總人口數,前次累計接種人數更新,新增接種人數,累計接種人數,累計接種率,累計配送劑數,剩餘庫存量
793,210609,臺北市,2581006,144190,1650,145840,5.65,157700,7.52
794,210609,新北市,4027730,116615,633,117248,2.91,112000,0.00
796,210609,臺中市,2820979,94726,1158,95884,3.40,96700,0.84
798,210609,高雄市,2760028,86980,152,87132,3.16,90200,3.40
795,210609,桃園市,2270971,75234,4579,79813,3.51,89600,10.92
797,210609,臺南市,1871224,45552,607,46159,2.47,48100,4.04
800,210609,彰化縣,1262673,29493,1092,30585,2.42,36400,15.98
802,210609,屏東縣,809765,18632,40,18672,2.31,19200,2.75
799,210609,新竹縣,572422,14051,198,14249,2.49,15200,6.26
801,210609,雲林縣,674622,13967,275,14242,2.11,14300,0.41
805,210609,新竹市,452229,14025,177,14202,3.14,13900,0.00
809,210609,花蓮縣,323441,13578,280,13858,4.28,15100,8.23
807,210609,嘉義市,265416,13133,377,13510,5.09,14900,9.33
804,210609,宜蘭縣,452355,12656,12,12668,2.80,13000,2.55
811,210609,南投縣,489148,10855,279,11134,2.28,11200,0.59
808,210609,嘉義縣,497641,10849,121,10970,2.20,11500,4.61
803,210609,基隆市,367088,10197,388,10585,2.88,12700,16.65
806,210609,苗栗縣,541226,9710,160,9870,1.82,10500,6.00
810,210609,臺東縣,214599,5540,0,5540,2.58,5900,6.10
812,210609,澎湖縣,105905,3227,144,3371,3.18,3700,8.89
813,210609,金門縣,140325,2202,118,2320,1.65,2500,7.20
814,210609,連江縣,13403,1586,308,1894,14.13,2100,9.81
573,210608,臺北市,2581006,137199,4244,141443,5.48,141000,0.00
574,210608,新北市,4027730,116509,131,116640,2.90,106300,0.00
576,210608,臺中市,2820979,93829,535,94364,3.35,89400,0.00
578,210608,高雄市,2760028,87002,142,87144,3.16,83400,0.00
575,210608,桃園市,2270971,71152,4223,75375,3.32,81100,7.06
577,210608,臺南市,1871224,44683,857,45540,2.43,43000,0.00
580,210608,彰化縣,1262673,28793,671,29464,2.33,32500,9.34
582,210608,屏東縣,809765,18496,0,18496,2.28,17400,0.00
579,210608,新竹縣,572422,13803,256,14059,2.46,13600,0.00
585,210608,新竹市,452229,13992,35,14027,3.10,13000,0.00
581,210608,雲林縣,674622,13967,0,13967,2.07,12700,0.00
589,210608,花蓮縣,323441,12820,475,13295,4.11,13200,0.00
587,210608,嘉義市,265416,12803,476,13279,5.00,12600,0.00
584,210608,宜蘭縣,452355,12388,145,12533,2.77,11600,0.00
591,210608,南投縣,489148,10732,124,10856,2.22,9900,0.00
588,210608,嘉義縣,497641,10678,169,10847,2.18,10400,0.00
583,210608,基隆市,367088,9940,52,9992,2.72,11600,13.86
586,210608,苗栗縣,541226,9430,269,9699,1.79,9400,0.00
590,210608,臺東縣,214599,5532,11,5543,2.58,5100,0.00
592,210608,澎湖縣,105905,2982,245,3227,3.05,3400,5.09
593,210608,金門縣,140325,2168,34,2202,1.57,2300,4.26
594,210608,連江縣,13403,1433,153,1586,11.83,2000,20.70
221,210607,臺北市,2581006,130077,4740,134817,5.22,141000,4.39
222,210607,新北市,4027730,115840,660,116500,2.89,106300,0.00
224,210607,臺中市,2820979,92635,171,92806,3.29,89400,0.00
226,210607,高雄市,2760028,86073,473,86546,3.14,83400,0.00
223,210607,桃園市,2270971,67254,3891,71145,3.13,81100,12.27
225,210607,臺南市,1871224,43340,535,43875,2.34,43000,0.00
228,210607,彰化縣,1262673,28167,590,28757,2.28,32500,11.52
230,210607,屏東縣,809765,18376,119,18495,2.28,17400,0.00
229,210607,雲林縣,674622,13967,0,13967,2.07,12700,0.00
233,210607,新竹市,452229,13313,567,13880,3.07,13000,0.00
227,210607,新竹縣,572422,13803,0,13803,2.41,13600,0.00
235,210607,嘉義市,265416,12403,359,12762,4.81,12600,0.00
237,210607,花蓮縣,323441,11954,799,12753,3.94,13200,3.39
232,210607,宜蘭縣,452355,12012,128,12140,2.68,11600,0.00
239,210607,南投縣,489148,10609,123,10732,2.19,9900,0.00
236,210607,嘉義縣,497641,10476,181,10657,2.14,10400,0.00
231,210607,基隆市,367088,9641,0,9641,2.63,11600,16.89
234,210607,苗栗縣,541226,9327,103,9430,1.74,9400,0.00
238,210607,臺東縣,214599,5532,0,5532,2.58,5100,0.00
240,210607,澎湖縣,105905,2762,219,2981,2.81,3400,12.32
241,210607,金門縣,140325,2112,55,2167,1.54,2300,5.78
242,210607,連江縣,13403,1334,99,1433,10.69,2000,28.35
331,210606,臺北市,2581006,117345,10842,128187,4.97,141000,9.09
332,210606,新北市,4027730,113916,1291,115207,2.86,106300,0.00
336,210606,高雄市,2760028,85760,10,85770,3.11,83400,0.00
334,210606,臺中市,2820979,84593,1027,85620,3.04,89400,4.23
333,210606,桃園市,2270971,66855,399,67254,2.96,81100,17.07
335,210606,臺南市,1871224,40617,2144,42761,2.29,43000,0.56
338,210606,彰化縣,1262673,28060,93,28153,2.23,32500,13.38
340,210606,屏東縣,809765,18360,0,18360,2.27,17400,0.00
339,210606,雲林縣,674622,13623,344,13967,2.07,12700,0.00
337,210606,新竹縣,572422,13791,0,13791,2.41,13600,0.00
343,210606,新竹市,452229,13313,0,13313,2.94,13000,0.00
342,210606,宜蘭縣,452355,11900,95,11995,2.65,11600,0.00
345,210606,嘉義市,265416,11396,431,11827,4.46,12600,6.13
347,210606,花蓮縣,323441,11451,209,11660,3.60,13200,11.67
349,210606,南投縣,489148,10597,12,10609,2.17,9900,0.00
346,210606,嘉義縣,497641,10244,23,10267,2.06,10400,1.28
341,210606,基隆市,367088,9298,138,9436,2.57,11600,18.66
344,210606,苗栗縣,541226,9316,11,9327,1.72,9400,0.78
348,210606,臺東縣,214599,5404,73,5477,2.55,5100,0.00
350,210606,澎湖縣,105905,2761,0,2761,2.61,3400,18.79
351,210606,金門縣,140325,2111,0,2111,1.50,2300,8.22
352,210606,連江縣,13403,1271,63,1334,9.95,2000,33.30
881,210604,臺北市,2581006,104663,11254,115917,4.49,141000,17.79
882,210604,新北市,4027730,104192,9524,113716,2.82,106300,0.00
886,210604,高雄市,2760028,74952,9850,84802,3.07,83400,0.00
884,210604,臺中市,2820979,82618,1960,84578,3.00,89400,5.39
883,210604,桃園市,2270971,62643,4212,66855,2.94,81100,17.56
885,210604,臺南市,1871224,35900,4131,40031,2.14,43000,6.90
888,210604,彰化縣,1262673,26478,1502,27980,2.22,32500,13.91
890,210604,屏東縣,809765,16638,1690,18328,2.26,17400,0.00
887,210604,新竹縣,572422,13175,616,13791,2.41,13600,0.00
889,210604,雲林縣,674622,11461,2162,13623,2.02,12700,0.00
893,210604,新竹市,452229,13265,48,13313,2.94,13000,0.00
892,210604,宜蘭縣,452355,11175,725,11900,2.63,11600,0.00
897,210604,花蓮縣,323441,10495,956,11451,3.54,13200,13.25
895,210604,嘉義市,265416,9544,1852,11396,4.29,12600,9.56
899,210604,南投縣,489148,9858,739,10597,2.17,9900,0.00
896,210604,嘉義縣,497641,9426,784,10210,2.05,10400,1.83
894,210604,苗栗縣,541226,8592,724,9316,1.72,9400,0.89
891,210604,基隆市,367088,9140,48,9188,2.50,11600,20.79
898,210604,臺東縣,214599,4574,709,5283,2.46,5100,0.00
900,210604,澎湖縣,105905,2515,246,2761,2.61,3400,18.79
901,210604,金門縣,140325,1710,401,2111,1.50,2300,8.22
902,210604,連江縣,13403,1118,153,1271,9.48,2000,36.45
508,210603,新北市,4027730,92380,11627,104007,2.58,106300,2.16
507,210603,臺北市,2581006,94204,9634,103838,4.02,140900,26.30
510,210603,臺中市,2820979,77684,4771,82455,2.92,84300,2.19
512,210603,高雄市,2760028,65993,8709,74702,2.71,83400,10.43
509,210603,桃園市,2270971,58287,4353,62640,2.76,70600,11.27
511,210603,臺南市,1871224,32265,3259,35524,1.90,43000,17.39
514,210603,彰化縣,1262673,24777,1413,26190,2.07,30800,14.97
516,210603,屏東縣,809765,14566,1917,16483,2.04,17400,5.27
519,210603,新竹市,452229,12592,666,13258,2.93,12400,0.00
513,210603,新竹縣,572422,11807,1361,13168,2.30,13100,0.00
515,210603,雲林縣,674622,10224,1237,11461,1.70,12700,9.76
518,210603,宜蘭縣,452355,10242,831,11073,2.45,11600,4.54
523,210603,花蓮縣,323441,10324,95,10419,3.22,13200,21.07
525,210603,南投縣,489148,8979,879,9858,2.02,9900,0.42
521,210603,嘉義市,265416,8395,1149,9544,3.60,12600,24.25
522,210603,嘉義縣,497641,8850,519,9369,1.88,10400,9.91
517,210603,基隆市,367088,8822,121,8943,2.44,9500,5.86
520,210603,苗栗縣,541226,7766,821,8587,1.59,8800,2.42
524,210603,臺東縣,214599,3795,666,4461,2.08,5100,12.53
526,210603,澎湖縣,105905,2287,228,2515,2.37,3400,26.03
527,210603,金門縣,140325,1403,307,1710,1.22,2300,25.65
528,210603,連江縣,13403,944,173,1117,8.33,1400,20.21
595,210602,臺北市,2581006,84995,8700,93695,3.63,139700,32.93
596,210602,新北市,4027730,80255,10582,90837,2.26,106300,14.55
598,210602,臺中市,2820979,66962,10579,77541,2.75,83600,7.25
600,210602,高雄市,2760028,58439,7310,65749,2.38,81800,19.62
597,210602,桃園市,2270971,54688,2749,57437,2.53,70200,18.18
599,210602,臺南市,1871224,29207,2703,31910,1.71,43000,25.79
602,210602,彰化縣,1262673,23786,959,24745,1.96,30800,19.66
604,210602,屏東縣,809765,12505,1710,14215,1.76,16900,15.89
607,210602,新竹市,452229,10894,1694,12588,2.78,12300,0.00
601,210602,新竹縣,572422,10505,1291,11796,2.06,13100,9.95
611,210602,花蓮縣,323441,9519,756,10275,3.18,13000,20.96
606,210602,宜蘭縣,452355,9789,452,10241,2.26,11600,11.72
603,210602,雲林縣,674622,8662,1562,10224,1.52,12700,19.50
613,210602,南投縣,489148,7670,1309,8979,1.84,9900,9.30
610,210602,嘉義縣,497641,8119,721,8840,1.78,10400,15.00
605,210602,基隆市,367088,8343,123,8466,2.31,9500,10.88
609,210602,嘉義市,265416,7448,946,8394,3.16,12600,33.38
608,210602,苗栗縣,541226,7050,651,7701,1.42,8800,12.49
612,210602,臺東縣,214599,3030,764,3794,1.77,5000,24.12
614,210602,澎湖縣,105905,2075,210,2285,2.16,3400,32.79
615,210602,金門縣,140325,1184,219,1403,1.00,2300,39.00
616,210602,連江縣,13403,747,167,914,6.82,1400,34.71
463,210601,臺北市,2581006,81693,2650,84343,3.27,139700,39.63
464,210601,新北市,4027730,71024,6845,77869,1.93,106300,26.75
466,210601,臺中市,2820979,60785,6101,66886,2.37,73600,9.12
468,210601,高雄市,2760028,56896,613,57509,2.08,81800,29.70
465,210601,桃園市,2270971,51023,3547,54570,2.40,70200,22.26
467,210601,臺南市,1871224,28795,411,29206,1.56,43000,32.08
470,210601,彰化縣,1262673,21448,2134,23582,1.87,30800,23.44
472,210601,屏東縣,809765,11357,1144,12501,1.54,16900,26.03
475,210601,新竹市,452229,9637,1257,10894,2.41,12300,11.43
469,210601,新竹縣,572422,8605,1882,10487,1.83,13100,19.95
474,210601,宜蘭縣,452355,9044,621,9665,2.14,11600,16.68
479,210601,花蓮縣,323441,8827,690,9517,2.94,13000,26.79
471,210601,雲林縣,674622,6719,1619,8338,1.24,12700,34.35
473,210601,基隆市,367088,8128,0,8128,2.21,9500,14.44
478,210601,嘉義縣,497641,7285,794,8079,1.62,10400,22.32
481,210601,南投縣,489148,7119,551,7670,1.57,9900,22.53
477,210601,嘉義市,265416,6407,997,7404,2.79,12600,41.24
476,210601,苗栗縣,541226,6106,872,6978,1.29,8800,20.70
480,210601,臺東縣,214599,2909,109,3018,1.41,5000,39.64
482,210601,澎湖縣,105905,1712,290,2002,1.89,3400,41.12
483,210601,金門縣,140325,1049,135,1184,0.84,2300,48.52
484,210601,連江縣,13403,650,97,747,5.57,1400,46.64
771,210531,臺北市,2581006,74666,4087,78753,3.05,114700,31.34
772,210531,新北市,4027730,61899,8228,70127,1.74,106300,34.03
774,210531,臺中市,2820979,49221,11395,60616,2.15,63600,4.69
776,210531,高雄市,2760028,56364,143,56507,2.05,81800,30.92
773,210531,桃園市,2270971,48694,2324,51018,2.25,68100,25.08
775,210531,臺南市,1871224,27665,910,28575,1.53,43000,33.55
778,210531,彰化縣,1262673,20828,605,21433,1.70,30800,30.41
780,210531,屏東縣,809765,10041,1305,11346,1.40,16900,32.86
783,210531,新竹市,452229,9099,538,9637,2.13,12300,21.65
782,210531,宜蘭縣,452355,8463,496,8959,1.98,9900,9.51
787,210531,花蓮縣,323441,8374,396,8770,2.71,8800,0.34
777,210531,新竹縣,572422,8290,311,8601,1.50,11700,26.49
781,210531,基隆市,367088,7524,168,7692,2.10,9500,19.03
786,210531,嘉義縣,497641,6392,846,7238,1.45,10400,30.40
789,210531,南投縣,489148,6687,432,7119,1.46,9900,28.09
779,210531,雲林縣,674622,5889,643,6532,0.97,12700,48.57
785,210531,嘉義市,265416,5917,468,6385,2.41,12600,49.33
784,210531,苗栗縣,541226,5656,399,6055,1.12,8800,31.19
788,210531,臺東縣,214599,2419,454,2873,1.34,3500,17.91
790,210531,澎湖縣,105905,1611,101,1712,1.62,3400,49.65
791,210531,金門縣,140325,1049,0,1049,0.75,2300,54.39
792,210531,連江縣,13403,584,66,650,4.85,1400,53.57
705,210530,臺北市,2581006,63926,5905,69831,2.71,0,0.00
706,210530,新北市,4027730,59401,2320,61721,1.53,0,0.00
710,210530,高雄市,2760028,45434,9748,55182,2.00,0,0.00
708,210530,臺中市,2820979,44566,4651,49217,1.74,0,0.00
707,210530,桃園市,2270971,44156,4529,48685,2.14,0,0.00
709,210530,臺南市,1871224,20138,6067,26205,1.40,0,0.00
712,210530,彰化縣,1262673,20284,484,20768,1.64,0,0.00
714,210530,屏東縣,809765,9860,176,10036,1.24,0,0.00
717,210530,新竹市,452229,7569,1528,9097,2.01,0,0.00
716,210530,宜蘭縣,452355,8366,88,8454,1.87,0,0.00
721,210530,花蓮縣,323441,8227,125,8352,2.58,0,0.00
711,210530,新竹縣,572422,8215,74,8289,1.45,0,0.00
715,210530,基隆市,367088,6980,34,7014,1.91,0,0.00
723,210530,南投縣,489148,6676,0,6676,1.36,0,0.00
720,210530,嘉義縣,497641,6008,384,6392,1.28,0,0.00
719,210530,嘉義市,265416,5811,100,5911,2.23,0,0.00
718,210530,苗栗縣,541226,5633,22,5655,1.04,0,0.00
713,210530,雲林縣,674622,4993,92,5085,0.75,0,0.00
722,210530,臺東縣,214599,2419,0,2419,1.13,0,0.00
724,210530,澎湖縣,105905,1590,0,1590,1.50,0,0.00
725,210530,金門縣,140325,1049,0,1049,0.75,0,0.00
726,210530,連江縣,13403,582,0,582,4.34,0,0.00
89,210528,臺北市,2581006,58547,5164,63711,2.47,0,0.00
90,210528,新北市,4027730,53845,5502,59347,1.47,0,0.00
92,210528,臺中市,2820979,41346,3196,44542,1.58,0,0.00
91,210528,桃園市,2270971,39880,4276,44156,1.94,0,0.00
94,210528,高雄市,2760028,35859,7768,43627,1.58,0,0.00
96,210528,彰化縣,1262673,18582,1685,20267,1.61,0,0.00
93,210528,臺南市,1871224,14682,4762,19444,1.04,0,0.00
98,210528,屏東縣,809765,7833,1978,9811,1.21,0,0.00
100,210528,宜蘭縣,452355,7685,681,8366,1.85,0,0.00
105,210528,花蓮縣,323441,6822,1405,8227,2.54,0,0.00
95,210528,新竹縣,572422,7572,643,8215,1.44,0,0.00
101,210528,新竹市,452229,5956,1610,7566,1.67,0,0.00
99,210528,基隆市,367088,6191,768,6959,1.90,0,0.00
107,210528,南投縣,489148,5920,755,6675,1.36,0,0.00
103,210528,嘉義市,265416,4960,851,5811,2.19,0,0.00
102,210528,苗栗縣,541226,5031,580,5611,1.04,0,0.00
104,210528,嘉義縣,497641,4961,499,5460,1.10,0,0.00
97,210528,雲林縣,674622,4666,176,4842,0.72,0,0.00
106,210528,臺東縣,214599,2017,402,2419,1.13,0,0.00
108,210528,澎湖縣,105905,1524,66,1590,1.50,0,0.00
109,210528,金門縣,140325,896,153,1049,0.75,0,0.00
110,210528,連江縣,13403,582,0,582,4.34,0,0.00
265,210527,臺北市,2581006,57291,1066,58357,2.26,0,0.00
266,210527,新北市,4027730,52005,931,52936,1.31,0,0.00
268,210527,臺中市,2820979,40510,834,41344,1.47,0,0.00
267,210527,桃園市,2270971,39522,358,39880,1.76,0,0.00
270,210527,高雄市,2760028,34747,1111,35858,1.30,0,0.00
272,210527,彰化縣,1262673,18144,416,18560,1.47,0,0.00
269,210527,臺南市,1871224,14562,120,14682,0.78,0,0.00
274,210527,屏東縣,809765,7663,170,7833,0.97,0,0.00
276,210527,宜蘭縣,452355,7334,351,7685,1.70,0,0.00
271,210527,新竹縣,572422,7532,40,7572,1.32,0,0.00
281,210527,花蓮縣,323441,6633,167,6800,2.10,0,0.00
275,210527,基隆市,367088,5510,633,6143,1.67,0,0.00
277,210527,新竹市,452229,5832,124,5956,1.32,0,0.00
283,210527,南投縣,489148,5115,791,5906,1.21,0,0.00
278,210527,苗栗縣,541226,4957,74,5031,0.93,0,0.00
279,210527,嘉義市,265416,4772,188,4960,1.87,0,0.00
273,210527,雲林縣,674622,4622,44,4666,0.69,0,0.00
280,210527,嘉義縣,497641,4466,137,4603,0.92,0,0.00
282,210527,臺東縣,214599,2006,11,2017,0.94,0,0.00
284,210527,澎湖縣,105905,1415,87,1502,1.42,0,0.00
285,210527,金門縣,140325,863,33,896,0.64,0,0.00
286,210527,連江縣,13403,518,11,529,3.95,0,0.00
23,210526,臺北市,2581006,55223,1706,56929,2.21,0,0.00
24,210526,新北市,4027730,51518,487,52005,1.29,0,0.00
26,210526,臺中市,2820979,39681,829,40510,1.44,0,0.00
25,210526,桃園市,2270971,39204,317,39521,1.74,0,0.00
28,210526,高雄市,2760028,34067,679,34746,1.26,0,0.00
30,210526,彰化縣,1262673,17766,282,18048,1.43,0,0.00
27,210526,臺南市,1871224,14376,186,14562,0.78,0,0.00
32,210526,屏東縣,809765,7618,45,7663,0.95,0,0.00
29,210526,新竹縣,572422,7286,246,7532,1.32,0,0.00
34,210526,宜蘭縣,452355,7195,139,7334,1.62,0,0.00
39,210526,花蓮縣,323441,6579,33,6612,2.04,0,0.00
35,210526,新竹市,452229,5797,35,5832,1.29,0,0.00
33,210526,基隆市,367088,5233,146,5379,1.47,0,0.00
41,210526,南投縣,489148,5072,43,5115,1.05,0,0.00
36,210526,苗栗縣,541226,4957,0,4957,0.92,0,0.00
37,210526,嘉義市,265416,4523,111,4634,1.75,0,0.00
31,210526,雲林縣,674622,4600,22,4622,0.69,0,0.00
38,210526,嘉義縣,497641,4431,13,4444,0.89,0,0.00
40,210526,臺東縣,214599,1982,24,2006,0.93,0,0.00
42,210526,澎湖縣,105905,1391,24,1415,1.34,0,0.00
43,210526,金門縣,140325,810,53,863,0.62,0,0.00
44,210526,連江縣,13403,486,32,518,3.86,0,0.00
287,210525,臺北市,2581006,52879,2347,55226,2.14,0,0.00
288,210525,新北市,4027730,50199,1259,51458,1.28,0,0.00
290,210525,臺中市,2820979,39234,447,39681,1.41,0,0.00
289,210525,桃園市,2270971,38672,532,39204,1.73,0,0.00
292,210525,高雄市,2760028,32939,1010,33949,1.23,0,0.00
294,210525,彰化縣,1262673,17245,510,17755,1.41,0,0.00
291,210525,臺南市,1871224,13880,482,14362,0.77,0,0.00
296,210525,屏東縣,809765,7605,46,7651,0.94,0,0.00
293,210525,新竹縣,572422,7195,111,7306,1.28,0,0.00
298,210525,宜蘭縣,452355,6936,259,7195,1.59,0,0.00
303,210525,花蓮縣,323441,6501,78,6579,2.03,0,0.00
299,210525,新竹市,452229,5773,24,5797,1.28,0,0.00
297,210525,基隆市,367088,5101,132,5233,1.43,0,0.00
305,210525,南投縣,489148,4981,97,5078,1.04,0,0.00
300,210525,苗栗縣,541226,4801,156,4957,0.92,0,0.00
295,210525,雲林縣,674622,4486,114,4600,0.68,0,0.00
301,210525,嘉義市,265416,4369,154,4523,1.70,0,0.00
302,210525,嘉義縣,497641,4407,35,4442,0.89,0,0.00
304,210525,臺東縣,214599,1946,36,1982,0.92,0,0.00
306,210525,澎湖縣,105905,1333,58,1391,1.31,0,0.00
307,210525,金門縣,140325,788,22,810,0.58,0,0.00
308,210525,連江縣,13403,409,77,486,3.63,0,0.00
67,210524,臺北市,2581006,51262,2100,53362,2.07,0,0.00
68,210524,新北市,4027730,48374,1775,50149,1.25,0,0.00
70,210524,臺中市,2820979,38964,271,39235,1.39,0,0.00
69,210524,桃園市,2270971,37888,785,38673,1.70,0,0.00
72,210524,高雄市,2760028,31827,1074,32901,1.19,0,0.00
74,210524,彰化縣,1262673,16939,162,17101,1.35,0,0.00
71,210524,臺南市,1871224,13529,350,13879,0.74,0,0.00
76,210524,屏東縣,809765,7436,136,7572,0.94,0,0.00
73,210524,新竹縣,572422,6950,213,7163,1.25,0,0.00
78,210524,宜蘭縣,452355,6725,139,6864,1.52,0,0.00
83,210524,花蓮縣,323441,6281,143,6424,1.99,0,0.00
79,210524,新竹市,452229,5706,67,5773,1.28,0,0.00
77,210524,基隆市,367088,4961,140,5101,1.39,0,0.00
85,210524,南投縣,489148,4795,180,4975,1.02,0,0.00
80,210524,苗栗縣,541226,4701,100,4801,0.89,0,0.00
75,210524,雲林縣,674622,4429,57,4486,0.66,0,0.00
82,210524,嘉義縣,497641,4219,155,4374,0.88,0,0.00
81,210524,嘉義市,265416,4247,122,4369,1.65,0,0.00
84,210524,臺東縣,214599,1864,82,1946,0.91,0,0.00
86,210524,澎湖縣,105905,1274,59,1333,1.26,0,0.00
87,210524,金門縣,140325,788,0,788,0.56,0,0.00
88,210524,連江縣,13403,409,0,409,3.05,0,0.00
683,210523,臺北市,2581006,50383,879,51262,1.99,0,0.00
684,210523,新北市,4027730,47472,377,47849,1.19,0,0.00
686,210523,臺中市,2820979,38882,0,38882,1.38,0,0.00
685,210523,桃園市,2270971,37878,11,37889,1.67,0,0.00
688,210523,高雄市,2760028,31827,0,31827,1.15,0,0.00
690,210523,彰化縣,1262673,16891,1,16892,1.34,0,0.00
687,210523,臺南市,1871224,12990,467,13457,0.72,0,0.00
692,210523,屏東縣,809765,7399,37,7436,0.92,0,0.00
689,210523,新竹縣,572422,6846,105,6951,1.21,0,0.00
694,210523,宜蘭縣,452355,6702,0,6702,1.48,0,0.00
699,210523,花蓮縣,323441,6080,199,6279,1.94,0,0.00
695,210523,新竹市,452229,5706,0,5706,1.26,0,0.00
693,210523,基隆市,367088,4889,48,4937,1.34,0,0.00
701,210523,南投縣,489148,4784,10,4794,0.98,0,0.00
696,210523,苗栗縣,541226,4602,34,4636,0.86,0,0.00
691,210523,雲林縣,674622,4395,34,4429,0.66,0,0.00
697,210523,嘉義市,265416,4235,0,4235,1.60,0,0.00
698,210523,嘉義縣,497641,4208,11,4219,0.85,0,0.00
700,210523,臺東縣,214599,1835,10,1845,0.86,0,0.00
702,210523,澎湖縣,105905,1274,0,1274,1.20,0,0.00
703,210523,金門縣,140325,788,0,788,0.56,0,0.00
704,210523,連江縣,13403,409,0,409,3.05,0,0.00
1057,210521,臺北市,2581006,47263,3099,50362,1.95,0,0.00
1058,210521,新北市,4027730,44032,3018,47050,1.17,0,0.00
1060,210521,臺中市,2820979,37221,1661,38882,1.38,0,0.00
1059,210521,桃園市,2270971,35752,2126,37878,1.67,0,0.00
1062,210521,高雄市,2760028,29486,2334,31820,1.15,0,0.00
1064,210521,彰化縣,1262673,15613,1169,16782,1.33,0,0.00
1061,210521,臺南市,1871224,12561,429,12990,0.69,0,0.00
1066,210521,屏東縣,809765,6893,506,7399,0.91,0,0.00
1063,210521,新竹縣,572422,6452,394,6846,1.20,0,0.00
1068,210521,宜蘭縣,452355,6183,519,6702,1.48,0,0.00
1073,210521,花蓮縣,323441,5882,198,6080,1.88,0,0.00
1069,210521,新竹市,452229,5322,312,5634,1.25,0,0.00
1067,210521,基隆市,367088,4595,294,4889,1.33,0,0.00
1075,210521,南投縣,489148,4553,231,4784,0.98,0,0.00
1070,210521,苗栗縣,541226,4132,470,4602,0.85,0,0.00
1065,210521,雲林縣,674622,4057,338,4395,0.65,0,0.00
1071,210521,嘉義市,265416,4149,86,4235,1.60,0,0.00
1072,210521,嘉義縣,497641,4095,113,4208,0.85,0,0.00
1074,210521,臺東縣,214599,1724,111,1835,0.86,0,0.00
1076,210521,澎湖縣,105905,1172,102,1274,1.20,0,0.00
1077,210521,金門縣,140325,678,110,788,0.56,0,0.00
1078,210521,連江縣,13403,376,33,409,3.05,0,0.00
639,210520,臺北市,2581006,45143,1823,46966,1.82,0,0.00
640,210520,新北市,4027730,41171,2803,43974,1.09,0,0.00
642,210520,臺中市,2820979,35001,2218,37219,1.32,0,0.00
641,210520,桃園市,2270971,32921,2853,35774,1.58,0,0.00
644,210520,高雄市,2760028,28398,1153,29551,1.07,0,0.00
646,210520,彰化縣,1262673,14471,1050,15521,1.23,0,0.00
643,210520,臺南市,1871224,12160,323,12483,0.67,0,0.00
648,210520,屏東縣,809765,6423,461,6884,0.85,0,0.00
645,210520,新竹縣,572422,6325,153,6478,1.13,0,0.00
650,210520,宜蘭縣,452355,5920,262,6182,1.37,0,0.00
655,210520,花蓮縣,323441,5773,110,5883,1.82,0,0.00
651,210520,新竹市,452229,4887,436,5323,1.18,0,0.00
657,210520,南投縣,489148,4067,486,4553,0.93,0,0.00
649,210520,基隆市,367088,4451,72,4523,1.23,0,0.00
654,210520,嘉義縣,497641,4138,70,4208,0.85,0,0.00
653,210520,嘉義市,265416,4007,139,4146,1.56,0,0.00
647,210520,雲林縣,674622,3962,96,4058,0.60,0,0.00
652,210520,苗栗縣,541226,3645,361,4006,0.74,0,0.00
656,210520,臺東縣,214599,1577,123,1700,0.79,0,0.00
658,210520,澎湖縣,105905,1065,114,1179,1.11,0,0.00
659,210520,金門縣,140325,590,88,678,0.48,0,0.00
660,210520,連江縣,13403,320,38,358,2.67,0,0.00
925,210519,臺北市,2581006,42657,1118,43775,1.70,0,0.00
926,210519,新北市,4027730,37774,3231,41005,1.02,0,0.00
928,210519,臺中市,2820979,32759,2240,34999,1.24,0,0.00
927,210519,桃園市,2270971,29949,2971,32920,1.45,0,0.00
930,210519,高雄市,2760028,26876,1388,28264,1.02,0,0.00
932,210519,彰化縣,1262673,12981,1473,14454,1.14,0,0.00
929,210519,臺南市,1871224,11295,844,12139,0.65,0,0.00
934,210519,屏東縣,809765,5818,597,6415,0.79,0,0.00
931,210519,新竹縣,572422,5861,464,6325,1.10,0,0.00
936,210519,宜蘭縣,452355,5351,567,5918,1.31,0,0.00
941,210519,花蓮縣,323441,5338,435,5773,1.78,0,0.00
937,210519,新竹市,452229,4513,374,4887,1.08,0,0.00
935,210519,基隆市,367088,4379,36,4415,1.20,0,0.00
940,210519,嘉義縣,497641,4016,78,4094,0.82,0,0.00
943,210519,南投縣,489148,3724,338,4062,0.83,0,0.00
939,210519,嘉義市,265416,3828,179,4007,1.51,0,0.00
933,210519,雲林縣,674622,3737,225,3962,0.59,0,0.00
938,210519,苗栗縣,541226,3379,265,3644,0.67,0,0.00
942,210519,臺東縣,214599,1432,124,1556,0.73,0,0.00
944,210519,澎湖縣,105905,1043,22,1065,1.01,0,0.00
945,210519,金門縣,140325,471,119,590,0.42,0,0.00
946,210519,連江縣,13403,276,44,320,2.39,0,0.00
661,210518,臺北市,2581006,40045,1964,42009,1.63,0,0.00
662,210518,新北市,4027730,32809,3996,36805,0.91,0,0.00
664,210518,臺中市,2820979,29635,3002,32637,1.16,0,0.00
663,210518,桃園市,2270971,26558,3391,29949,1.32,0,0.00
666,210518,高雄市,2760028,25348,1507,26855,0.97,0,0.00
668,210518,彰化縣,1262673,11636,1202,12838,1.02,0,0.00
665,210518,臺南市,1871224,10303,962,11265,0.60,0,0.00
667,210518,新竹縣,572422,5495,366,5861,1.02,0,0.00
670,210518,屏東縣,809765,5311,496,5807,0.72,0,0.00
672,210518,宜蘭縣,452355,4580,771,5351,1.18,0,0.00
677,210518,花蓮縣,323441,4926,311,5237,1.62,0,0.00
673,210518,新竹市,452229,4099,414,4513,1.00,0,0.00
671,210518,基隆市,367088,3851,504,4355,1.19,0,0.00
676,210518,嘉義縣,497641,3623,391,4014,0.81,0,0.00
675,210518,嘉義市,265416,3412,414,3826,1.44,0,0.00
679,210518,南投縣,489148,3495,219,3714,0.76,0,0.00
669,210518,雲林縣,674622,2836,570,3406,0.50,0,0.00
674,210518,苗栗縣,541226,3052,304,3356,0.62,0,0.00
678,210518,臺東縣,214599,1202,218,1420,0.66,0,0.00
680,210518,澎湖縣,105905,986,57,1043,0.98,0,0.00
681,210518,金門縣,140325,363,108,471,0.34,0,0.00
682,210518,連江縣,13403,231,45,276,2.06,0,0.00
419,210517,臺北市,2581006,35336,3664,39000,1.51,0,0.00
420,210517,新北市,4027730,28160,3594,31754,0.79,0,0.00
422,210517,臺中市,2820979,26063,3507,29570,1.05,0,0.00
421,210517,桃園市,2270971,23682,2875,26557,1.17,0,0.00
424,210517,高雄市,2760028,23694,1619,25313,0.92,0,0.00
426,210517,彰化縣,1262673,9591,1297,10888,0.86,0,0.00
423,210517,臺南市,1871224,9255,927,10182,0.54,0,0.00
425,210517,新竹縣,572422,4800,695,5495,0.96,0,0.00
428,210517,屏東縣,809765,4684,618,5302,0.65,0,0.00
435,210517,花蓮縣,323441,4198,597,4795,1.48,0,0.00
430,210517,宜蘭縣,452355,3758,820,4578,1.01,0,0.00
431,210517,新竹市,452229,3529,566,4095,0.91,0,0.00
429,210517,基隆市,367088,3492,356,3848,1.05,0,0.00
434,210517,嘉義縣,497641,2947,593,3540,0.71,0,0.00
433,210517,嘉義市,265416,3212,199,3411,1.29,0,0.00
437,210517,南投縣,489148,3061,342,3403,0.70,0,0.00
432,210517,苗栗縣,541226,2891,150,3041,0.56,0,0.00
427,210517,雲林縣,674622,2463,370,2833,0.42,0,0.00
436,210517,臺東縣,214599,1082,85,1167,0.54,0,0.00
438,210517,澎湖縣,105905,876,110,986,0.93,0,0.00
439,210517,金門縣,140325,363,0,363,0.26,0,0.00
440,210517,連江縣,13403,220,11,231,1.72,0,0.00
199,210516,臺北市,2581006,31535,2827,34362,1.33,0,0.00
200,210516,新北市,4027730,27417,676,28093,0.70,0,0.00
202,210516,臺中市,2820979,24781,1225,26006,0.92,0,0.00
201,210516,桃園市,2270971,23367,257,23624,1.04,0,0.00
204,210516,高雄市,2760028,22059,1205,23264,0.84,0,0.00
206,210516,彰化縣,1262673,9232,342,9574,0.76,0,0.00
203,210516,臺南市,1871224,8768,0,8768,0.47,0,0.00
205,210516,新竹縣,572422,4595,153,4748,0.83,0,0.00
208,210516,屏東縣,809765,4599,10,4609,0.57,0,0.00
215,210516,花蓮縣,323441,3925,209,4134,1.28,0,0.00
210,210516,宜蘭縣,452355,3735,23,3758,0.83,0,0.00
211,210516,新竹市,452229,3131,396,3527,0.78,0,0.00
209,210516,基隆市,367088,3416,0,3416,0.93,0,0.00
213,210516,嘉義市,265416,3206,0,3206,1.21,0,0.00
217,210516,南投縣,489148,3019,0,3019,0.62,0,0.00
212,210516,苗栗縣,541226,2891,0,2891,0.53,0,0.00
214,210516,嘉義縣,497641,2722,0,2722,0.55,0,0.00
207,210516,雲林縣,674622,2289,162,2451,0.36,0,0.00
216,210516,臺東縣,214599,1082,0,1082,0.50,0,0.00
218,210516,澎湖縣,105905,841,0,841,0.79,0,0.00
219,210516,金門縣,140325,363,0,363,0.26,0,0.00
220,210516,連江縣,13403,220,0,220,1.64,0,0.00
155,210514,臺北市,2581006,27489,3905,31394,1.22,0,0.00
156,210514,新北市,4027730,20774,6356,27130,0.67,0,0.00
158,210514,臺中市,2820979,20104,4675,24779,0.88,0,0.00
157,210514,桃園市,2270971,19745,3621,23366,1.03,0,0.00
160,210514,高雄市,2760028,18599,3454,22053,0.80,0,0.00
162,210514,彰化縣,1262673,7056,2176,9232,0.73,0,0.00
159,210514,臺南市,1871224,7753,840,8593,0.46,0,0.00
164,210514,屏東縣,809765,3672,917,4589,0.57,0,0.00
161,210514,新竹縣,572422,3749,826,4575,0.80,0,0.00
171,210514,花蓮縣,323441,3225,657,3882,1.20,0,0.00
166,210514,宜蘭縣,452355,2762,973,3735,0.83,0,0.00
165,210514,基隆市,367088,2937,479,3416,0.93,0,0.00
169,210514,嘉義市,265416,2748,458,3206,1.21,0,0.00
173,210514,南投縣,489148,2553,466,3019,0.62,0,0.00
167,210514,新竹市,452229,2494,414,2908,0.64,0,0.00
168,210514,苗栗縣,541226,2152,604,2756,0.51,0,0.00
170,210514,嘉義縣,497641,2253,469,2722,0.55,0,0.00
163,210514,雲林縣,674622,1660,629,2289,0.34,0,0.00
172,210514,臺東縣,214599,933,148,1081,0.50,0,0.00
174,210514,澎湖縣,105905,657,184,841,0.79,0,0.00
175,210514,金門縣,140325,263,100,363,0.26,0,0.00
176,210514,連江縣,13403,220,0,220,1.64,0,0.00
485,210513,臺北市,2581006,24647,2204,26851,1.04,0,0.00
486,210513,新北市,4027730,17064,3639,20703,0.51,0,0.00
488,210513,臺中市,2820979,16548,3553,20101,0.71,0,0.00
487,210513,桃園市,2270971,17252,2362,19614,0.86,0,0.00
490,210513,高雄市,2760028,16304,2153,18457,0.67,0,0.00
489,210513,臺南市,1871224,6813,939,7752,0.41,0,0.00
492,210513,彰化縣,1262673,5361,1597,6958,0.55,0,0.00
491,210513,新竹縣,572422,3339,410,3749,0.65,0,0.00
494,210513,屏東縣,809765,2935,613,3548,0.44,0,0.00
501,210513,花蓮縣,323441,2614,392,3006,0.93,0,0.00
495,210513,基隆市,367088,2516,422,2938,0.80,0,0.00
496,210513,宜蘭縣,452355,2194,568,2762,0.61,0,0.00
499,210513,嘉義市,265416,2340,398,2738,1.03,0,0.00
503,210513,南投縣,489148,1750,759,2509,0.51,0,0.00
497,210513,新竹市,452229,2213,281,2494,0.55,0,0.00
500,210513,嘉義縣,497641,1903,242,2145,0.43,0,0.00
498,210513,苗栗縣,541226,1601,394,1995,0.37,0,0.00
493,210513,雲林縣,674622,1567,93,1660,0.25,0,0.00
502,210513,臺東縣,214599,735,152,887,0.41,0,0.00
504,210513,澎湖縣,105905,460,187,647,0.61,0,0.00
505,210513,金門縣,140325,263,0,263,0.19,0,0.00
506,210513,連江縣,13403,184,36,220,1.64,0,0.00
1013,210512,臺北市,2581006,22344,2250,24594,0.95,0,0.00
1015,210512,桃園市,2270971,15890,1329,17219,0.76,0,0.00
1014,210512,新北市,4027730,14129,2790,16919,0.42,0,0.00
1016,210512,臺中市,2820979,13827,2720,16547,0.59,0,0.00
1018,210512,高雄市,2760028,14627,1669,16296,0.59,0,0.00
1017,210512,臺南市,1871224,6004,788,6792,0.36,0,0.00
1020,210512,彰化縣,1262673,4028,1131,5159,0.41,0,0.00
1019,210512,新竹縣,572422,2807,467,3274,0.57,0,0.00
1022,210512,屏東縣,809765,2328,530,2858,0.35,0,0.00
1029,210512,花蓮縣,323441,2302,308,2610,0.81,0,0.00
1023,210512,基隆市,367088,2158,358,2516,0.69,0,0.00
1027,210512,嘉義市,265416,2041,299,2340,0.88,0,0.00
1024,210512,宜蘭縣,452355,1921,272,2193,0.48,0,0.00
1025,210512,新竹市,452229,1860,237,2097,0.46,0,0.00
1028,210512,嘉義縣,497641,1679,122,1801,0.36,0,0.00
1031,210512,南投縣,489148,1549,200,1749,0.36,0,0.00
1021,210512,雲林縣,674622,1353,214,1567,0.23,0,0.00
1026,210512,苗栗縣,541226,1279,260,1539,0.28,0,0.00
1030,210512,臺東縣,214599,649,43,692,0.32,0,0.00
1032,210512,澎湖縣,105905,332,128,460,0.43,0,0.00
1033,210512,金門縣,140325,263,0,263,0.19,0,0.00
1034,210512,連江縣,13403,119,65,184,1.37,0,0.00
969,210511,臺北市,2581006,20361,1501,21862,0.85,0,0.00
971,210511,桃園市,2270971,14265,1478,15743,0.69,0,0.00
974,210511,高雄市,2760028,13539,1083,14622,0.53,0,0.00
970,210511,新北市,4027730,12303,1703,14006,0.35,0,0.00
972,210511,臺中市,2820979,12310,1509,13819,0.49,0,0.00
973,210511,臺南市,1871224,5353,650,6003,0.32,0,0.00
976,210511,彰化縣,1262673,3378,636,4014,0.32,0,0.00
975,210511,新竹縣,572422,2539,268,2807,0.49,0,0.00
978,210511,屏東縣,809765,2011,283,2294,0.28,0,0.00
985,210511,花蓮縣,323441,2042,229,2271,0.70,0,0.00
979,210511,基隆市,367088,1878,280,2158,0.59,0,0.00
983,210511,嘉義市,265416,1898,143,2041,0.77,0,0.00
980,210511,宜蘭縣,452355,1694,227,1921,0.42,0,0.00
981,210511,新竹市,452229,1649,178,1827,0.40,0,0.00
984,210511,嘉義縣,497641,1534,136,1670,0.34,0,0.00
987,210511,南投縣,489148,1404,145,1549,0.32,0,0.00
977,210511,雲林縣,674622,1112,227,1339,0.20,0,0.00
982,210511,苗栗縣,541226,1057,179,1236,0.23,0,0.00
986,210511,臺東縣,214599,539,108,647,0.30,0,0.00
988,210511,澎湖縣,105905,277,55,332,0.31,0,0.00
989,210511,金門縣,140325,263,0,263,0.19,0,0.00
990,210511,連江縣,13403,119,0,119,0.89,0,0.00
111,210510,臺北市,2581006,18927,1357,20284,0.79,0,0.00
113,210510,桃園市,2270971,13026,1236,14262,0.63,0,0.00
116,210510,高雄市,2760028,12125,1399,13524,0.49,0,0.00
114,210510,臺中市,2820979,11077,1227,12304,0.44,0,0.00
112,210510,新北市,4027730,11003,1299,12302,0.31,0,0.00
115,210510,臺南市,1871224,4781,551,5332,0.28,0,0.00
118,210510,彰化縣,1262673,3030,326,3356,0.27,0,0.00
117,210510,新竹縣,572422,2398,141,2539,0.44,0,0.00
127,210510,花蓮縣,323441,1868,172,2040,0.63,0,0.00
120,210510,屏東縣,809765,1839,172,2011,0.25,0,0.00
125,210510,嘉義市,265416,1753,147,1900,0.72,0,0.00
121,210510,基隆市,367088,1705,173,1878,0.51,0,0.00
122,210510,宜蘭縣,452355,1575,119,1694,0.37,0,0.00
123,210510,新竹市,452229,1472,177,1649,0.36,0,0.00
126,210510,嘉義縣,497641,1462,69,1531,0.31,0,0.00
129,210510,南投縣,489148,1165,238,1403,0.29,0,0.00
119,210510,雲林縣,674622,1044,68,1112,0.16,0,0.00
124,210510,苗栗縣,541226,980,77,1057,0.20,0,0.00
128,210510,臺東縣,214599,511,28,539,0.25,0,0.00
130,210510,澎湖縣,105905,210,67,277,0.26,0,0.00
131,210510,金門縣,140325,263,0,263,0.19,0,0.00
132,210510,連江縣,13403,119,0,119,0.89,0,0.00
309,210509,臺北市,2581006,18639,202,18841,0.73,0,0.00
311,210509,桃園市,2270971,12879,74,12953,0.57,0,0.00
314,210509,高雄市,2760028,11899,207,12106,0.44,0,0.00
312,210509,臺中市,2820979,10916,161,11077,0.39,0,0.00
310,210509,新北市,4027730,10824,165,10989,0.27,0,0.00
313,210509,臺南市,1871224,4693,57,4750,0.25,0,0.00
316,210509,彰化縣,1262673,2918,112,3030,0.24,0,0.00
315,210509,新竹縣,572422,2397,0,2397,0.42,0,0.00
325,210509,花蓮縣,323441,1828,40,1868,0.58,0,0.00
318,210509,屏東縣,809765,1830,8,1838,0.23,0,0.00
323,210509,嘉義市,265416,1751,0,1751,0.66,0,0.00
319,210509,基隆市,367088,1705,0,1705,0.46,0,0.00
320,210509,宜蘭縣,452355,1575,0,1575,0.35,0,0.00
324,210509,嘉義縣,497641,1462,0,1462,0.29,0,0.00
321,210509,新竹市,452229,1421,21,1442,0.32,0,0.00
327,210509,南投縣,489148,1165,0,1165,0.24,0,0.00
317,210509,雲林縣,674622,1044,0,1044,0.15,0,0.00
322,210509,苗栗縣,541226,969,0,969,0.18,0,0.00
326,210509,臺東縣,214599,511,0,511,0.24,0,0.00
329,210509,金門縣,140325,247,0,247,0.18,0,0.00
328,210509,澎湖縣,105905,210,0,210,0.20,0,0.00
330,210509,連江縣,13403,119,0,119,0.89,0,0.00
133,210507,臺北市,2581006,17142,1512,18654,0.72,0,0.00
135,210507,桃園市,2270971,11130,1524,12654,0.56,0,0.00
138,210507,高雄市,2760028,10835,1224,12059,0.44,0,0.00
136,210507,臺中市,2820979,9728,1189,10917,0.39,0,0.00
134,210507,新北市,4027730,9588,1237,10825,0.27,0,0.00
137,210507,臺南市,1871224,4366,345,4711,0.25,0,0.00
140,210507,彰化縣,1262673,2546,372,2918,0.23,0,0.00
139,210507,新竹縣,572422,2087,310,2397,0.42,0,0.00
149,210507,花蓮縣,323441,1685,166,1851,0.57,0,0.00
142,210507,屏東縣,809765,1495,339,1834,0.23,0,0.00
147,210507,嘉義市,265416,1537,202,1739,0.66,0,0.00
143,210507,基隆市,367088,1395,310,1705,0.46,0,0.00
144,210507,宜蘭縣,452355,1417,158,1575,0.35,0,0.00
148,210507,嘉義縣,497641,1292,170,1462,0.29,0,0.00
145,210507,新竹市,452229,1230,191,1421,0.31,0,0.00
151,210507,南投縣,489148,980,185,1165,0.24,0,0.00
141,210507,雲林縣,674622,903,141,1044,0.15,0,0.00
146,210507,苗栗縣,541226,806,163,969,0.18,0,0.00
150,210507,臺東縣,214599,477,34,511,0.24,0,0.00
153,210507,金門縣,140325,220,42,262,0.19,0,0.00
152,210507,澎湖縣,105905,159,51,210,0.20,0,0.00
154,210507,連江縣,13403,119,0,119,0.89,0,0.00
243,210506,臺北市,2581006,15884,1251,17135,0.66,0,0.00
245,210506,桃園市,2270971,9971,949,10920,0.48,0,0.00
248,210506,高雄市,2760028,10159,676,10835,0.39,0,0.00
246,210506,臺中市,2820979,8917,812,9729,0.34,0,0.00
244,210506,新北市,4027730,8739,812,9551,0.24,0,0.00
247,210506,臺南市,1871224,4000,366,4366,0.23,0,0.00
250,210506,彰化縣,1262673,2276,270,2546,0.20,0,0.00
249,210506,新竹縣,572422,1914,173,2087,0.36,0,0.00
259,210506,花蓮縣,323441,1550,134,1684,0.52,0,0.00
257,210506,嘉義市,265416,1431,106,1537,0.58,0,0.00
252,210506,屏東縣,809765,1431,53,1484,0.18,0,0.00
254,210506,宜蘭縣,452355,1285,132,1417,0.31,0,0.00
253,210506,基隆市,367088,1221,174,1395,0.38,0,0.00
258,210506,嘉義縣,497641,1216,76,1292,0.26,0,0.00
255,210506,新竹市,452229,1122,107,1229,0.27,0,0.00
261,210506,南投縣,489148,808,172,980,0.20,0,0.00
251,210506,雲林縣,674622,869,34,903,0.13,0,0.00
256,210506,苗栗縣,541226,738,68,806,0.15,0,0.00
260,210506,臺東縣,214599,400,67,467,0.22,0,0.00
263,210506,金門縣,140325,220,0,220,0.16,0,0.00
262,210506,澎湖縣,105905,159,0,159,0.15,0,0.00
264,210506,連江縣,13403,90,29,119,0.89,0,0.00
441,210505,臺北市,2581006,14615,1012,15627,0.61,0,0.00
446,210505,高雄市,2760028,9659,501,10160,0.37,0,0.00
443,210505,桃園市,2270971,8858,1114,9972,0.44,0,0.00
444,210505,臺中市,2820979,8137,780,8917,0.32,0,0.00
442,210505,新北市,4027730,7749,928,8677,0.22,0,0.00
445,210505,臺南市,1871224,3733,245,3978,0.21,0,0.00
448,210505,彰化縣,1262673,2032,244,2276,0.18,0,0.00
447,210505,新竹縣,572422,1752,162,1914,0.33,0,0.00
457,210505,花蓮縣,323441,1380,132,1512,0.47,0,0.00
455,210505,嘉義市,265416,1323,108,1431,0.54,0,0.00
450,210505,屏東縣,809765,1298,113,1411,0.17,0,0.00
452,210505,宜蘭縣,452355,1223,62,1285,0.28,0,0.00
451,210505,基隆市,367088,1108,113,1221,0.33,0,0.00
456,210505,嘉義縣,497641,1125,91,1216,0.24,0,0.00
453,210505,新竹市,452229,1022,100,1122,0.25,0,0.00
449,210505,雲林縣,674622,828,41,869,0.13,0,0.00
459,210505,南投縣,489148,725,83,808,0.17,0,0.00
454,210505,苗栗縣,541226,684,47,731,0.14,0,0.00
458,210505,臺東縣,214599,392,0,392,0.18,0,0.00
461,210505,金門縣,140325,169,51,220,0.16,0,0.00
460,210505,澎湖縣,105905,159,0,159,0.15,0,0.00
462,210505,連江縣,13403,90,0,90,0.67,0,0.00
397,210504,臺北市,2581006,13447,1134,14581,0.56,0,0.00
402,210504,高雄市,2760028,9038,586,9624,0.35,0,0.00
399,210504,桃園市,2270971,7957,901,8858,0.39,0,0.00
400,210504,臺中市,2820979,7508,627,8135,0.29,0,0.00
398,210504,新北市,4027730,7127,605,7732,0.19,0,0.00
401,210504,臺南市,1871224,3466,240,3706,0.20,0,0.00
404,210504,彰化縣,1262673,1706,326,2032,0.16,0,0.00
403,210504,新竹縣,572422,1676,76,1752,0.31,0,0.00
413,210504,花蓮縣,323441,1284,92,1376,0.43,0,0.00
411,210504,嘉義市,265416,1222,101,1323,0.50,0,0.00
406,210504,屏東縣,809765,1242,54,1296,0.16,0,0.00
408,210504,宜蘭縣,452355,1195,28,1223,0.27,0,0.00
412,210504,嘉義縣,497641,1060,65,1125,0.23,0,0.00
407,210504,基隆市,367088,1013,95,1108,0.30,0,0.00
409,210504,新竹市,452229,985,37,1022,0.23,0,0.00
405,210504,雲林縣,674622,736,92,828,0.12,0,0.00
415,210504,南投縣,489148,613,112,725,0.15,0,0.00
410,210504,苗栗縣,541226,586,96,682,0.13,0,0.00
414,210504,臺東縣,214599,337,48,385,0.18,0,0.00
417,210504,金門縣,140325,169,0,169,0.12,0,0.00
416,210504,澎湖縣,105905,159,0,159,0.15,0,0.00
418,210504,連江縣,13403,90,0,90,0.67,0,0.00
1035,210503,臺北市,2581006,12482,900,13382,0.52,0,0.00
1040,210503,高雄市,2760028,8318,556,8874,0.32,0,0.00
1037,210503,桃園市,2270971,7469,495,7964,0.35,0,0.00
1038,210503,臺中市,2820979,6985,523,7508,0.27,0,0.00
1036,210503,新北市,4027730,6504,649,7153,0.18,0,0.00
1039,210503,臺南市,1871224,3218,248,3466,0.19,0,0.00
1042,210503,彰化縣,1262673,1635,93,1728,0.14,0,0.00
1041,210503,新竹縣,572422,1569,106,1675,0.29,0,0.00
1051,210503,花蓮縣,323441,1172,100,1272,0.39,0,0.00
1044,210503,屏東縣,809765,1222,20,1242,0.15,0,0.00
1049,210503,嘉義市,265416,1140,82,1222,0.46,0,0.00
1046,210503,宜蘭縣,452355,1129,66,1195,0.26,0,0.00
1050,210503,嘉義縣,497641,1011,49,1060,0.21,0,0.00
1045,210503,基隆市,367088,937,76,1013,0.28,0,0.00
1047,210503,新竹市,452229,917,68,985,0.22,0,0.00
1043,210503,雲林縣,674622,697,39,736,0.11,0,0.00
1053,210503,南投縣,489148,561,57,618,0.13,0,0.00
1048,210503,苗栗縣,541226,571,18,589,0.11,0,0.00
1052,210503,臺東縣,214599,331,6,337,0.16,0,0.00
1055,210503,金門縣,140325,169,0,169,0.12,0,0.00
1054,210503,澎湖縣,105905,144,15,159,0.15,0,0.00
1056,210503,連江縣,13403,90,0,90,0.67,0,0.00
551,210502,臺北市,2581006,12391,73,12464,0.48,0,0.00
556,210502,高雄市,2760028,8318,0,8318,0.30,0,0.00
553,210502,桃園市,2270971,7321,148,7469,0.33,0,0.00
554,210502,臺中市,2820979,6948,37,6985,0.25,0,0.00
552,210502,新北市,4027730,6504,0,6504,0.16,0,0.00
555,210502,臺南市,1871224,3218,0,3218,0.17,0,0.00
558,210502,彰化縣,1262673,1635,0,1635,0.13,0,0.00
557,210502,新竹縣,572422,1569,0,1569,0.27,0,0.00
560,210502,屏東縣,809765,1222,0,1222,0.15,0,0.00
567,210502,花蓮縣,323441,1164,8,1172,0.36,0,0.00
565,210502,嘉義市,265416,1140,0,1140,0.43,0,0.00
562,210502,宜蘭縣,452355,1129,0,1129,0.25,0,0.00
566,210502,嘉義縣,497641,1011,0,1011,0.20,0,0.00
561,210502,基隆市,367088,937,0,937,0.26,0,0.00
563,210502,新竹市,452229,919,0,919,0.20,0,0.00
559,210502,雲林縣,674622,675,21,696,0.10,0,0.00
564,210502,苗栗縣,541226,571,0,571,0.11,0,0.00
569,210502,南投縣,489148,561,0,561,0.11,0,0.00
568,210502,臺東縣,214599,331,0,331,0.15,0,0.00
571,210502,金門縣,140325,169,0,169,0.12,0,0.00
570,210502,澎湖縣,105905,144,0,144,0.14,0,0.00
572,210502,連江縣,13403,88,0,88,0.66,0,0.00
617,210430,臺北市,2581006,11470,881,12351,0.48,0,0.00
622,210430,高雄市,2760028,8009,284,8293,0.30,0,0.00
619,210430,桃園市,2270971,6823,498,7321,0.32,0,0.00
620,210430,臺中市,2820979,6485,462,6947,0.25,0,0.00
618,210430,新北市,4027730,5956,548,6504,0.16,0,0.00
621,210430,臺南市,1871224,3112,106,3218,0.17,0,0.00
624,210430,彰化縣,1262673,1497,130,1627,0.13,0,0.00
623,210430,新竹縣,572422,1412,149,1561,0.27,0,0.00
626,210430,屏東縣,809765,1136,87,1223,0.15,0,0.00
633,210430,花蓮縣,323441,1088,76,1164,0.36,0,0.00
631,210430,嘉義市,265416,1051,89,1140,0.43,0,0.00
628,210430,宜蘭縣,452355,1075,54,1129,0.25,0,0.00
632,210430,嘉義縣,497641,1011,0,1011,0.20,0,0.00
627,210430,基隆市,367088,877,60,937,0.26,0,0.00
629,210430,新竹市,452229,828,91,919,0.20,0,0.00
625,210430,雲林縣,674622,609,65,674,0.10,0,0.00
630,210430,苗栗縣,541226,528,43,571,0.11,0,0.00
635,210430,南投縣,489148,532,29,561,0.11,0,0.00
634,210430,臺東縣,214599,321,11,332,0.15,0,0.00
637,210430,金門縣,140325,142,27,169,0.12,0,0.00
636,210430,澎湖縣,105905,144,0,144,0.14,0,0.00
638,210430,連江縣,13403,88,0,88,0.66,0,0.00
903,210429,臺北市,2581006,10901,569,11470,0.44,0,0.00
908,210429,高雄市,2760028,7598,411,8009,0.29,0,0.00
905,210429,桃園市,2270971,6240,583,6823,0.30,0,0.00
906,210429,臺中市,2820979,6125,360,6485,0.23,0,0.00
904,210429,新北市,4027730,5579,377,5956,0.15,0,0.00
907,210429,臺南市,1871224,2954,157,3111,0.17,0,0.00
910,210429,彰化縣,1262673,1371,126,1497,0.12,0,0.00
909,210429,新竹縣,572422,1286,126,1412,0.25,0,0.00
912,210429,屏東縣,809765,1073,63,1136,0.14,0,0.00
919,210429,花蓮縣,323441,1045,40,1085,0.34,0,0.00
914,210429,宜蘭縣,452355,1004,71,1075,0.24,0,0.00
917,210429,嘉義市,265416,1000,51,1051,0.40,0,0.00
918,210429,嘉義縣,497641,970,41,1011,0.20,0,0.00
913,210429,基隆市,367088,811,66,877,0.24,0,0.00
915,210429,新竹市,452229,773,54,827,0.18,0,0.00
911,210429,雲林縣,674622,599,10,609,0.09,0,0.00
921,210429,南投縣,489148,493,39,532,0.11,0,0.00
916,210429,苗栗縣,541226,528,0,528,0.10,0,0.00
920,210429,臺東縣,214599,287,34,321,0.15,0,0.00
922,210429,澎湖縣,105905,116,28,144,0.14,0,0.00
923,210429,金門縣,140325,142,0,142,0.10,0,0.00
924,210429,連江縣,13403,70,18,88,0.66,0,0.00
375,210428,臺北市,2581006,10242,625,10867,0.42,0,0.00
380,210428,高雄市,2760028,7354,244,7598,0.28,0,0.00
377,210428,桃園市,2270971,5734,478,6212,0.27,0,0.00
378,210428,臺中市,2820979,5823,302,6125,0.22,0,0.00
376,210428,新北市,4027730,5154,388,5542,0.14,0,0.00
379,210428,臺南市,1871224,2837,106,2943,0.16,0,0.00
382,210428,彰化縣,1262673,1290,81,1371,0.11,0,0.00
381,210428,新竹縣,572422,1196,90,1286,0.22,0,0.00
384,210428,屏東縣,809765,1063,9,1072,0.13,0,0.00
391,210428,花蓮縣,323441,1011,26,1037,0.32,0,0.00
386,210428,宜蘭縣,452355,998,6,1004,0.22,0,0.00
389,210428,嘉義市,265416,942,58,1000,0.38,0,0.00
390,210428,嘉義縣,497641,933,33,966,0.19,0,0.00
385,210428,基隆市,367088,776,35,811,0.22,0,0.00
387,210428,新竹市,452229,720,45,765,0.17,0,0.00
383,210428,雲林縣,674622,582,16,598,0.09,0,0.00
388,210428,苗栗縣,541226,510,18,528,0.10,0,0.00
393,210428,南投縣,489148,472,21,493,0.10,0,0.00
392,210428,臺東縣,214599,287,0,287,0.13,0,0.00
395,210428,金門縣,140325,116,26,142,0.10,0,0.00
394,210428,澎湖縣,105905,116,0,116,0.11,0,0.00
396,210428,連江縣,13403,70,0,70,0.52,0,0.00
45,210425,臺北市,2581006,8724,117,8841,0.34,0,0.00
50,210425,高雄市,2760028,6953,0,6953,0.25,0,0.00
48,210425,臺中市,2820979,5158,11,5169,0.18,0,0.00
47,210425,桃園市,2270971,4699,0,4699,0.21,0,0.00
46,210425,新北市,4027730,4204,0,4204,0.10,0,0.00
49,210425,臺南市,1871224,2654,0,2654,0.14,0,0.00
52,210425,彰化縣,1262673,1195,0,1195,0.09,0,0.00
51,210425,新竹縣,572422,1073,0,1073,0.19,0,0.00
54,210425,屏東縣,809765,1027,0,1027,0.13,0,0.00
61,210425,花蓮縣,323441,949,8,957,0.30,0,0.00
56,210425,宜蘭縣,452355,920,0,920,0.20,0,0.00
60,210425,嘉義縣,497641,893,0,893,0.18,0,0.00
59,210425,嘉義市,265416,842,0,842,0.32,0,0.00
55,210425,基隆市,367088,689,0,689,0.19,0,0.00
57,210425,新竹市,452229,678,0,678,0.15,0,0.00
53,210425,雲林縣,674622,480,0,480,0.07,0,0.00
58,210425,苗栗縣,541226,449,0,449,0.08,0,0.00
63,210425,南投縣,489148,421,0,421,0.09,0,0.00
62,210425,臺東縣,214599,236,0,236,0.11,0,0.00
65,210425,金門縣,140325,116,0,116,0.08,0,0.00
64,210425,澎湖縣,105905,106,0,106,0.10,0,0.00
66,210425,連江縣,13403,70,0,70,0.52,0,0.00
837,210416,臺北市,2581006,6033,426,6459,0.25,0,0.00
842,210416,高雄市,2760028,5216,549,5765,0.21,0,0.00
840,210416,臺中市,2820979,3734,151,3885,0.14,0,0.00
839,210416,桃園市,2270971,3280,232,3512,0.15,0,0.00
838,210416,新北市,4027730,2813,148,2961,0.07,0,0.00
841,210416,臺南市,1871224,2157,190,2347,0.13,0,0.00
844,210416,彰化縣,1262673,803,66,869,0.07,0,0.00
846,210416,屏東縣,809765,761,71,832,0.10,0,0.00
853,210416,花蓮縣,323441,754,43,797,0.25,0,0.00
852,210416,嘉義縣,497641,743,28,771,0.15,0,0.00
843,210416,新竹縣,572422,698,64,762,0.13,0,0.00
848,210416,宜蘭縣,452355,632,29,661,0.15,0,0.00
851,210416,嘉義市,265416,534,51,585,0.22,0,0.00
849,210416,新竹市,452229,491,20,511,0.11,0,0.00
847,210416,基隆市,367088,400,0,400,0.11,0,0.00
850,210416,苗栗縣,541226,306,0,306,0.06,0,0.00
845,210416,雲林縣,674622,256,41,297,0.04,0,0.00
855,210416,南投縣,489148,201,64,265,0.05,0,0.00
854,210416,臺東縣,214599,165,22,187,0.09,0,0.00
856,210416,澎湖縣,105905,80,10,90,0.08,0,0.00
857,210416,金門縣,140325,48,29,77,0.05,0,0.00
858,210416,連江縣,13403,50,0,50,0.37,0,0.00
749,210415,臺北市,2581006,5630,403,6033,0.23,0,0.00
754,210415,高雄市,2760028,4912,293,5205,0.19,0,0.00
752,210415,臺中市,2820979,3629,104,3733,0.13,0,0.00
751,210415,桃園市,2270971,3180,100,3280,0.14,0,0.00
750,210415,新北市,4027730,2744,69,2813,0.07,0,0.00
753,210415,臺南市,1871224,1935,118,2053,0.11,0,0.00
756,210415,彰化縣,1262673,730,73,803,0.06,0,0.00
758,210415,屏東縣,809765,697,64,761,0.09,0,0.00
765,210415,花蓮縣,323441,754,0,754,0.23,0,0.00
764,210415,嘉義縣,497641,732,11,743,0.15,0,0.00
755,210415,新竹縣,572422,698,0,698,0.12,0,0.00
760,210415,宜蘭縣,452355,595,37,632,0.14,0,0.00
763,210415,嘉義市,265416,502,32,534,0.20,0,0.00
761,210415,新竹市,452229,439,52,491,0.11,0,0.00
759,210415,基隆市,367088,333,67,400,0.11,0,0.00
762,210415,苗栗縣,541226,258,48,306,0.06,0,0.00
757,210415,雲林縣,674622,256,0,256,0.04,0,0.00
767,210415,南投縣,489148,180,21,201,0.04,0,0.00
766,210415,臺東縣,214599,155,10,165,0.08,0,0.00
768,210415,澎湖縣,105905,80,0,80,0.08,0,0.00
770,210415,連江縣,13403,10,40,50,0.37,0,0.00
769,210415,金門縣,140325,48,0,48,0.03,0,0.00
727,210414,臺北市,2581006,5630,403,6033,0.23,0,0.00
732,210414,高雄市,2760028,4912,293,5205,0.19,0,0.00
730,210414,臺中市,2820979,3629,104,3733,0.13,0,0.00
729,210414,桃園市,2270971,3180,100,3280,0.14,0,0.00
728,210414,新北市,4027730,2744,69,2813,0.07,0,0.00
731,210414,臺南市,1871224,1935,118,2053,0.11,0,0.00
734,210414,彰化縣,1262673,730,73,803,0.06,0,0.00
736,210414,屏東縣,809765,697,64,761,0.09,0,0.00
743,210414,花蓮縣,323441,754,0,754,0.23,0,0.00
742,210414,嘉義縣,497641,732,11,743,0.15,0,0.00
733,210414,新竹縣,572422,698,0,698,0.12,0,0.00
738,210414,宜蘭縣,452355,595,37,632,0.14,0,0.00
741,210414,嘉義市,265416,502,32,534,0.20,0,0.00
739,210414,新竹市,452229,439,52,491,0.11,0,0.00
737,210414,基隆市,367088,333,67,400,0.11,0,0.00
740,210414,苗栗縣,541226,258,48,306,0.06,0,0.00
735,210414,雲林縣,674622,256,0,256,0.04,0,0.00
745,210414,南投縣,489148,180,21,201,0.04,0,0.00
744,210414,臺東縣,214599,155,10,165,0.08,0,0.00
746,210414,澎湖縣,105905,80,0,80,0.08,0,0.00
748,210414,連江縣,13403,10,40,50,0.37,0,0.00
747,210414,金門縣,140325,48,0,48,0.03,0,0.00
529,210407,臺北市,2581006,3355,357,3712,0.14,0,0.00
534,210407,高雄市,2760028,3201,186,3387,0.12,0,0.00
532,210407,臺中市,2820979,2525,321,2846,0.10,0,0.00
531,210407,桃園市,2270971,2236,88,2324,0.10,0,0.00
530,210407,新北市,4027730,2036,84,2120,0.05,0,0.00
533,210407,臺南市,1871224,1361,51,1412,0.08,0,0.00
544,210407,嘉義縣,497641,517,35,552,0.11,0,0.00
545,210407,花蓮縣,323441,476,62,538,0.17,0,0.00
535,210407,新竹縣,572422,519,11,530,0.09,0,0.00
536,210407,彰化縣,1262673,456,60,516,0.04,0,0.00
540,210407,宜蘭縣,452355,412,42,454,0.10,0,0.00
538,210407,屏東縣,809765,325,11,336,0.04,0,0.00
541,210407,新竹市,452229,265,20,285,0.06,0,0.00
543,210407,嘉義市,265416,257,11,268,0.10,0,0.00
539,210407,基隆市,367088,214,12,226,0.06,0,0.00
542,210407,苗栗縣,541226,164,0,164,0.03,0,0.00
537,210407,雲林縣,674622,84,44,128,0.02,0,0.00
546,210407,臺東縣,214599,124,0,124,0.06,0,0.00
547,210407,南投縣,489148,83,0,83,0.02,0,0.00
548,210407,澎湖縣,105905,50,0,50,0.05,0,0.00
549,210407,金門縣,140325,20,0,20,0.01,0,0.00
550,210407,連江縣,13403,0,0,0,0.00,0,0.00
182,210405,高雄市,2760028,3055,30,3085,0.11,0,0.00
177,210405,臺北市,2581006,2944,63,3007,0.12,0,0.00
180,210405,臺中市,2820979,2300,0,2300,0.08,0,0.00
179,210405,桃園市,2270971,2064,0,2064,0.09,0,0.00
178,210405,新北市,4027730,1908,21,1929,0.05,0,0.00
181,210405,臺南市,1871224,1210,0,1210,0.06,0,0.00
192,210405,嘉義縣,497641,473,22,495,0.10,0,0.00
183,210405,新竹縣,572422,488,0,488,0.09,0,0.00
193,210405,花蓮縣,323441,476,0,476,0.15,0,0.00
184,210405,彰化縣,1262673,430,0,430,0.03,0,0.00
188,210405,宜蘭縣,452355,379,0,379,0.08,0,0.00
186,210405,屏東縣,809765,315,0,315,0.04,0,0.00
189,210405,新竹市,452229,244,0,244,0.05,0,0.00
191,210405,嘉義市,265416,184,21,205,0.08,0,0.00
187,210405,基隆市,367088,166,0,166,0.05,0,0.00
190,210405,苗栗縣,541226,122,10,132,0.02,0,0.00
194,210405,臺東縣,214599,113,0,113,0.05,0,0.00
195,210405,南投縣,489148,73,0,73,0.01,0,0.00
185,210405,雲林縣,674622,64,0,64,0.01,0,0.00
196,210405,澎湖縣,105905,50,0,50,0.05,0,0.00
197,210405,金門縣,140325,20,0,20,0.01,0,0.00
198,210405,連江縣,13403,0,0,0,0.00,0,0.00
864,210404,高雄市,2760028,3055,30,3085,0.11,0,0.00
859,210404,臺北市,2581006,2944,63,3007,0.12,0,0.00
862,210404,臺中市,2820979,2300,0,2300,0.08,0,0.00
861,210404,桃園市,2270971,2064,0,2064,0.09,0,0.00
860,210404,新北市,4027730,1908,21,1929,0.05,0,0.00
863,210404,臺南市,1871224,1210,0,1210,0.06,0,0.00
874,210404,嘉義縣,497641,473,22,495,0.10,0,0.00
865,210404,新竹縣,572422,488,0,488,0.09,0,0.00
875,210404,花蓮縣,323441,476,0,476,0.15,0,0.00
866,210404,彰化縣,1262673,430,0,430,0.03,0,0.00
870,210404,宜蘭縣,452355,379,0,379,0.08,0,0.00
868,210404,屏東縣,809765,315,0,315,0.04,0,0.00
871,210404,新竹市,452229,244,0,244,0.05,0,0.00
873,210404,嘉義市,265416,184,21,205,0.08,0,0.00
869,210404,基隆市,367088,166,0,166,0.05,0,0.00
872,210404,苗栗縣,541226,122,10,132,0.02,0,0.00
876,210404,臺東縣,214599,113,0,113,0.05,0,0.00
877,210404,南投縣,489148,73,0,73,0.01,0,0.00
867,210404,雲林縣,674622,64,0,64,0.01,0,0.00
878,210404,澎湖縣,105905,50,0,50,0.05,0,0.00
879,210404,金門縣,140325,20,0,20,0.01,0,0.00
880,210404,連江縣,13403,0,0,0,0.00,0,0.00
952,210403,高雄市,2760028,3055,0,3055,0.11,0,0.00
947,210403,臺北市,2581006,2944,0,2944,0.11,0,0.00
950,210403,臺中市,2820979,2300,0,2300,0.08,0,0.00
949,210403,桃園市,2270971,2064,0,2064,0.09,0,0.00
948,210403,新北市,4027730,1908,0,1908,0.05,0,0.00
951,210403,臺南市,1871224,1210,0,1210,0.06,0,0.00
953,210403,新竹縣,572422,488,0,488,0.09,0,0.00
963,210403,花蓮縣,323441,476,0,476,0.15,0,0.00
962,210403,嘉義縣,497641,473,0,473,0.10,0,0.00
954,210403,彰化縣,1262673,430,0,430,0.03,0,0.00
958,210403,宜蘭縣,452355,379,0,379,0.08,0,0.00
956,210403,屏東縣,809765,315,0,315,0.04,0,0.00
959,210403,新竹市,452229,244,0,244,0.05,0,0.00
961,210403,嘉義市,265416,184,0,184,0.07,0,0.00
957,210403,基隆市,367088,166,0,166,0.05,0,0.00
960,210403,苗栗縣,541226,122,0,122,0.02,0,0.00
964,210403,臺東縣,214599,113,0,113,0.05,0,0.00
965,210403,南投縣,489148,73,0,73,0.01,0,0.00
955,210403,雲林縣,674622,64,0,64,0.01,0,0.00
966,210403,澎湖縣,105905,50,0,50,0.05,0,0.00
967,210403,金門縣,140325,20,0,20,0.01,0,0.00
968,210403,連江縣,13403,0,0,0,0.00,0,0.00
820,210402,高雄市,2760028,3005,50,3055,0.11,0,0.00
815,210402,臺北市,2581006,2858,86,2944,0.11,0,0.00
818,210402,臺中市,2820979,2268,32,2300,0.08,0,0.00
817,210402,桃園市,2270971,1974,90,2064,0.09,0,0.00
816,210402,新北市,4027730,1694,192,1886,0.05,0,0.00
819,210402,臺南市,1871224,1210,0,1210,0.06,0,0.00
821,210402,新竹縣,572422,477,11,488,0.09,0,0.00
831,210402,花蓮縣,323441,443,33,476,0.15,0,0.00
830,210402,嘉義縣,497641,473,0,473,0.10,0,0.00
822,210402,彰化縣,1262673,404,26,430,0.03,0,0.00
826,210402,宜蘭縣,452355,379,0,379,0.08,0,0.00
824,210402,屏東縣,809765,305,10,315,0.04,0,0.00
827,210402,新竹市,452229,223,21,244,0.05,0,0.00
829,210402,嘉義市,265416,129,55,184,0.07,0,0.00
825,210402,基隆市,367088,166,0,166,0.05,0,0.00
828,210402,苗栗縣,541226,122,0,122,0.02,0,0.00
832,210402,臺東縣,214599,113,0,113,0.05,0,0.00
833,210402,南投縣,489148,73,0,73,0.01,0,0.00
823,210402,雲林縣,674622,64,0,64,0.01,0,0.00
834,210402,澎湖縣,105905,50,0,50,0.05,0,0.00
835,210402,金門縣,140325,20,0,20,0.01,0,0.00
836,210402,連江縣,13403,0,0,0,0.00,0,0.00
3,210324,桃園市,2270971,765,324,1089,0.05,0,0.00
6,210324,高雄市,2760028,678,402,1080,0.04,0,0.00
4,210324,臺中市,2820979,371,281,652,0.02,0,0.00
2,210324,新北市,4027730,239,203,442,0.01,0,0.00
5,210324,臺南市,1871224,121,121,242,0.01,0,0.00
1,210324,臺北市,2581006,48,5,222,0.01,0,0.00
7,210324,新竹縣,572422,112,63,175,0.03,0,0.00
17,210324,花蓮縣,323441,46,122,168,0.05,0,0.00
10,210324,屏東縣,809765,84,47,131,0.02,0,0.00
16,210324,嘉義縣,497641,66,33,99,0.02,0,0.00
12,210324,宜蘭縣,452355,52,41,93,0.02,0,0.00
8,210324,彰化縣,1262673,34,32,66,0.01,0,0.00
13,210324,新竹市,452229,10,50,60,0.01,0,0.00
18,210324,臺東縣,214599,51,0,51,0.02,0,0.00
15,210324,嘉義市,265416,33,0,33,0.01,0,0.00
14,210324,苗栗縣,541226,21,0,21,0.00,0,0.00
19,210324,南投縣,489148,19,0,19,0.00,0,0.00
9,210324,雲林縣,674622,11,0,11,0.00,0,0.00
11,210324,基隆市,367088,10,0,10,0.00,0,0.00
20,210324,澎湖縣,105905,10,0,10,0.01,0,0.00
21,210324,金門縣,140325,0,10,10,0.01,0,0.00
22,210324,連江縣,13403,0,0,0,0.00,0,0.00
993,210323,桃園市,2270971,343,422,765,0.03,0,0.00
996,210323,高雄市,2760028,353,325,678,0.02,0,0.00
991,210323,臺北市,2581006,302,184,486,0.02,0,0.00
994,210323,臺中市,2820979,103,268,371,0.01,0,0.00
992,210323,新北市,4027730,131,107,238,0.01,0,0.00
995,210323,臺南市,1871224,50,71,121,0.01,0,0.00
997,210323,新竹縣,572422,45,67,112,0.02,0,0.00
1000,210323,屏東縣,809765,40,44,84,0.01,0,0.00
1006,210323,嘉義縣,497641,33,33,66,0.01,0,0.00
1002,210323,宜蘭縣,452355,52,0,52,0.01,0,0.00
1008,210323,臺東縣,214599,10,41,51,0.02,0,0.00
1007,210323,花蓮縣,323441,46,0,46,0.01,0,0.00
998,210323,彰化縣,1262673,22,12,34,0.00,0,0.00
1005,210323,嘉義市,265416,0,33,33,0.01,0,0.00
1004,210323,苗栗縣,541226,11,10,21,0.00,0,0.00
1009,210323,南投縣,489148,9,10,19,0.00,0,0.00
999,210323,雲林縣,674622,0,11,11,0.00,0,0.00
1001,210323,基隆市,367088,10,0,10,0.00,0,0.00
1003,210323,新竹市,452229,10,0,10,0.00,0,0.00
1010,210323,澎湖縣,105905,10,0,10,0.01,0,0.00
1011,210323,金門縣,140325,0,0,0,0.00,0,0.00
1012,210323,連江縣,13403,0,0,0,0.00,0,0.00
358,210322,高雄市,2760028,0,353,353,0.01,0,0.00
355,210322,桃園市,2270971,0,343,343,0.02,0,0.00
353,210322,臺北市,2581006,0,301,301,0.01,0,0.00
354,210322,新北市,4027730,0,131,131,0.00,0,0.00
356,210322,臺中市,2820979,0,103,103,0.00,0,0.00
364,210322,宜蘭縣,452355,0,52,52,0.01,0,0.00
357,210322,臺南市,1871224,0,50,50,0.00,0,0.00
369,210322,花蓮縣,323441,0,46,46,0.01,0,0.00
359,210322,新竹縣,572422,0,45,45,0.01,0,0.00
362,210322,屏東縣,809765,0,40,40,0.00,0,0.00
368,210322,嘉義縣,497641,0,33,33,0.01,0,0.00
360,210322,彰化縣,1262673,0,21,21,0.00,0,0.00
366,210322,苗栗縣,541226,0,11,11,0.00,0,0.00
363,210322,基隆市,367088,0,10,10,0.00,0,0.00
365,210322,新竹市,452229,0,10,10,0.00,0,0.00
370,210322,臺東縣,214599,0,10,10,0.00,0,0.00
372,210322,澎湖縣,105905,0,10,10,0.01,0,0.00
371,210322,南投縣,489148,0,9,9,0.00,0,0.00
361,210322,雲林縣,674622,0,0,0,0.00,0,0.00
367,210322,嘉義市,265416,0,0,0,0.00,0,0.00
373,210322,金門縣,140325,0,0,0,0.00,0,0.00
374,210322,連江縣,13403,0,0,0,0.00,0,0.00
